"oP" = (/turf/space,/area/space)

(1,1,1) = {"
oPoPoPoPoPoPoPoPoPoPoPoPoPoPoPoPoPoPoPoPoPoPoPoPoPoPoPoPoPoPoPoPoPoPoPoPoPoPoPoPoPoPoPoPoPoPoPoP
oPoPoPoPoPoPoPoPoPoPoPoPoPoPoPoPoPoPoPoPoPoPoPoPoPoPoPoPoPoPoPoPoPoPoPoPoPoPoPoPoPoPoPoPoPoPoPoP
oPoPoPoPoPoPoPoPoPoPoPoPoPoPoPoPoPoPoPoPoPoPoPoPoPoPoPoPoPoPoPoPoPoPoPoPoPoPoPoPoPoPoPoPoPoPoPoP
oPoPoPoPoPoPoPoPoPoPoPoPoPoPoPoPoPoPoPoPoPoPoPoPoPoPoPoPoPoPoPoPoPoPoPoPoPoPoPoPoPoPoPoPoPoPoPoP
oPoPoPoPoPoPoPoPoPoPoPoPoPoPoPoPoPoPoPoPoPoPoPoPoPoPoPoPoPoPoPoPoPoPoPoPoPoPoPoPoPoPoPoPoPoPoPoP
oPoPoPoPoPoPoPoPoPoPoPoPoPoPoPoPoPoPoPoPoPoPoPoPoPoPoPoPoPoPoPoPoPoPoPoPoPoPoPoPoPoPoPoPoPoPoPoP
oPoPoPoPoPoPoPoPoPoPoPoPoPoPoPoPoPoPoPoPoPoPoPoPoPoPoPoPoPoPoPoPoPoPoPoPoPoPoPoPoPoPoPoPoPoPoPoP
oPoPoPoPoPoPoPoPoPoPoPoPoPoPoPoPoPoPoPoPoPoPoPoPoPoPoPoPoPoPoPoPoPoPoPoPoPoPoPoPoPoPoPoPoPoPoPoP
oPoPoPoPoPoPoPoPoPoPoPoPoPoPoPoPoPoPoPoPoPoPoPoPoPoPoPoPoPoPoPoPoPoPoPoPoPoPoPoPoPoPoPoPoPoPoPoP
oPoPoPoPoPoPoPoPoPoPoPoPoPoPoPoPoPoPoPoPoPoPoPoPoPoPoPoPoPoPoPoPoPoPoPoPoPoPoPoPoPoPoPoPoPoPoPoP
oPoPoPoPoPoPoPoPoPoPoPoPoPoPoPoPoPoPoPoPoPoPoPoPoPoPoPoPoPoPoPoPoPoPoPoPoPoPoPoPoPoPoPoPoPoPoPoP
oPoPoPoPoPoPoPoPoPoPoPoPoPoPoPoPoPoPoPoPoPoPoPoPoPoPoPoPoPoPoPoPoPoPoPoPoPoPoPoPoPoPoPoPoPoPoPoP
oPoPoPoPoPoPoPoPoPoPoPoPoPoPoPoPoPoPoPoPoPoPoPoPoPoPoPoPoPoPoPoPoPoPoPoPoPoPoPoPoPoPoPoPoPoPoPoP
oPoPoPoPoPoPoPoPoPoPoPoPoPoPoPoPoPoPoPoPoPoPoPoPoPoPoPoPoPoPoPoPoPoPoPoPoPoPoPoPoPoPoPoPoPoPoPoP
oPoPoPoPoPoPoPoPoPoPoPoPoPoPoPoPoPoPoPoPoPoPoPoPoPoPoPoPoPoPoPoPoPoPoPoPoPoPoPoPoPoPoPoPoPoPoPoP
oPoPoPoPoPoPoPoPoPoPoPoPoPoPoPoPoPoPoPoPoPoPoPoPoPoPoPoPoPoPoPoPoPoPoPoPoPoPoPoPoPoPoPoPoPoPoPoP
oPoPoPoPoPoPoPoPoPoPoPoPoPoPoPoPoPoPoPoPoPoPoPoPoPoPoPoPoPoPoPoPoPoPoPoPoPoPoPoPoPoPoPoPoPoPoPoP
oPoPoPoPoPoPoPoPoPoPoPoPoPoPoPoPoPoPoPoPoPoPoPoPoPoPoPoPoPoPoPoPoPoPoPoPoPoPoPoPoPoPoPoPoPoPoPoP
oPoPoPoPoPoPoPoPoPoPoPoPoPoPoPoPoPoPoPoPoPoPoPoPoPoPoPoPoPoPoPoPoPoPoPoPoPoPoPoPoPoPoPoPoPoPoPoP
oPoPoPoPoPoPoPoPoPoPoPoPoPoPoPoPoPoPoPoPoPoPoPoPoPoPoPoPoPoPoPoPoPoPoPoPoPoPoPoPoPoPoPoPoPoPoPoP
oPoPoPoPoPoPoPoPoPoPoPoPoPoPoPoPoPoPoPoPoPoPoPoPoPoPoPoPoPoPoPoPoPoPoPoPoPoPoPoPoPoPoPoPoPoPoPoP
oPoPoPoPoPoPoPoPoPoPoPoPoPoPoPoPoPoPoPoPoPoPoPoPoPoPoPoPoPoPoPoPoPoPoPoPoPoPoPoPoPoPoPoPoPoPoPoP
oPoPoPoPoPoPoPoPoPoPoPoPoPoPoPoPoPoPoPoPoPoPoPoPoPoPoPoPoPoPoPoPoPoPoPoPoPoPoPoPoPoPoPoPoPoPoPoP
oPoPoPoPoPoPoPoPoPoPoPoPoPoPoPoPoPoPoPoPoPoPoPoPoPoPoPoPoPoPoPoPoPoPoPoPoPoPoPoPoPoPoPoPoPoPoPoP
oPoPoPoPoPoPoPoPoPoPoPoPoPoPoPoPoPoPoPoPoPoPoPoPoPoPoPoPoPoPoPoPoPoPoPoPoPoPoPoPoPoPoPoPoPoPoPoP
oPoPoPoPoPoPoPoPoPoPoPoPoPoPoPoPoPoPoPoPoPoPoPoPoPoPoPoPoPoPoPoPoPoPoPoPoPoPoPoPoPoPoPoPoPoPoPoP
oPoPoPoPoPoPoPoPoPoPoPoPoPoPoPoPoPoPoPoPoPoPoPoPoPoPoPoPoPoPoPoPoPoPoPoPoPoPoPoPoPoPoPoPoPoPoPoP
oPoPoPoPoPoPoPoPoPoPoPoPoPoPoPoPoPoPoPoPoPoPoPoPoPoPoPoPoPoPoPoPoPoPoPoPoPoPoPoPoPoPoPoPoPoPoPoP
oPoPoPoPoPoPoPoPoPoPoPoPoPoPoPoPoPoPoPoPoPoPoPoPoPoPoPoPoPoPoPoPoPoPoPoPoPoPoPoPoPoPoPoPoPoPoPoP
oPoPoPoPoPoPoPoPoPoPoPoPoPoPoPoPoPoPoPoPoPoPoPoPoPoPoPoPoPoPoPoPoPoPoPoPoPoPoPoPoPoPoPoPoPoPoPoP
oPoPoPoPoPoPoPoPoPoPoPoPoPoPoPoPoPoPoPoPoPoPoPoPoPoPoPoPoPoPoPoPoPoPoPoPoPoPoPoPoPoPoPoPoPoPoPoP
oPoPoPoPoPoPoPoPoPoPoPoPoPoPoPoPoPoPoPoPoPoPoPoPoPoPoPoPoPoPoPoPoPoPoPoPoPoPoPoPoPoPoPoPoPoPoPoP
"}
